Argentina	AR
Argentine	AR
Belice	
Belize	
Bolivia	BO
Bolivie	BO
Brasil	BR
Brazil	BR
Chile	CL
Chili	CL
Chilli	CL
Colombia	CO
Costa Rica	CR
Ecuador	EC
El Salvador	SV
Guatemala	GT
Guiana	GF
Guyana	GF
Honduras	HN
Mexico	MX
Méjico	MX
México	MX
Nicaragua	NI
Nicarao	NI
Panama	
Panamá	
Paraguay	PY
Paraguái	PY
Peru	PE
Perú	PE
Surinam	
Suriname	
Uruguai	UY
Uruguay	UY
Venezuela	VE
